|-----------------------------------------------------------------------------|
|                                                                             |
|   |--------------------------------|   |--------------------------------|   |
|   |................................|   |................................|   |
|   |................................+###+................................|   |
|   |................................|   |................................|   |
|   |................................|   |................................|   |
|   |----------+---------------------|   |................|----------+----|   |
|              #                         |................|          #        |
|              ##########################+................|   |------+-----|  |
|              #                         |------+---------|   |............|  |
|   |----------+-------------|                  #             |............|  |
|   |........................|                  #             |............|  |
|   |........................|                  #    |--------|............|  |
|   |........................+#######################+.....................|  |
|   |........................|         #             |.....................|  |
|   |................|-------|  |------+-------|     |.....................|  |
|   |................|          |..............|     |.....................|  |
|   |................|          |..............|     |.....................|  |
|   |................|    |-----|..............+#####+.....................|  |
|   |................+####+....................|     |---------------------|  |
|   |----------------|    |....................|                              |
|                         |--------------------|                              |
|                                                                             |
|-----------------------------------------------------------------------------|